R 1000 800

NO ./pixel-heart.xpm
SO ./canadian-dollar.xpm
WE ./wall1.xpm

EA ./wall2.xpm
S ./hit.xpm
F 220,100,0

C 225,30,0



        1111111111111111111111
        1000000000110000000000111
        1011000001110022222200011
        100100000000002222000001
11111111101200000111202000000001
1000000000110000011101001021011
11110111111111011100000010021
11110111111111011101010010001
11000000110101011100000000001
1000200000000000100100001001 1  
1000000000000000011 11001N0111
110000011101010111111111101111
11110111 1111011     1111000111
11111111 1111111 1111111111111
