R 1000 800

NO ./pixel-heart.xpm
SO ./canadian-dollar.xpm
WE ./wall1.xpm

EA ./wall2.xpm
S ./hit.xpm
F 220,100,0

C 225,30,0



        1111111111111111111111111
        1000000000110000000000001
        1011000001110022222200 111
        100100000000002222000001
11111111101100000111202000000001
1000000000110000011101001002111111
11110111111111011100000010021
11110111111111011101010010001
11000000110101011100000000001
10002000000000001002000010001
10000000000000000101010010001
11000001110101011101011110N0111
11110111 1110101 101111010001
11111111 1111111 111111111111
