R 1300    1000

F 220,15,0
S ./xpm/hit.xpm
SO   ./xpm/canadian-dollar.xpm


WE ./xpm/wall1.xpm 
C                                                   70,30,0
EA ./xpm/wall2.xpm
NO   ./xpm/pixel-heart.xpm

        1111111111  111111111111
        1000000000110000000200111
        10110000111002002000000211
        100120000000000000000011
11111111101200000111000000000001
1000000000110000011101001021011
11110011111111011100000000021
11110011111111011101010010001
11000000110101011100000000001
1000200000000000100100001001 1  
1000000000000000011 11001N0111
110000011101010111111111101111
11110111 1111011     1111000111
11111111 1111111 1111111111111
