R    1300 950

C  70,30,0

NO   ./xpm/pixel-heart.xpm
SO          ./xpm/canadian-dollar.xpm
WE     ./xpm/wall1.xpm

EA    ./xpm/wall2.xpm
S    ./xpm/hit.xpm
F    220,15,0


                    11  111  111
                 1112111121111211111
111111111111111110000000000000000021
10E000000000000000000000002000000011
111111111111111110000000000000000021
                 1112111121111211111
                 1111111111111111111
