R    1800 1100

C  70,30,0

NO   ./xpm/pixel-heart.xpm
SO          ./xpm/canadian-dollar.xpm
WE     ./xpm/wall1.xpm

EA    ./xpm/wall2.xpm
S    ./xpm/hit.xpm
F    220,15,0

11111111111111111111111
10000000000000000000001
10000000000000000000001
10000000000000000000001
10000000000000000000001
1000000000W000000000001
10000000000000000000001
10000000000000000000001
10000000000000000000001
10000000000000000000001
11111111111111111111111
